18 20 3 16
1 1 1 1 1 1 1 1 1 1 1 1 1 1 1 1 1 1 1 1
1 0 0 0 0 0 0 0 0 0 0 0 0 0 0 0 0 0 0 1
1 1 1 1 1 1 0 0 2 3 0 0 0 0 5 5 5 5 0 1
1 0 0 0 1 1 0 0 5 4 0 0 0 0 0 0 0 5 0 1
1 0 0 0 1 1 0 0 0 0 0 0 0 0 5 5 5 5 0 1
1 0 0 0 1 1 0 0 0 0 0 0 0 0 0 0 0 0 0 1
1 0 0 0 1 1 0 0 5 4 0 0 2 2 2 2 2 2 2 1
1 0 0 0 0 0 0 0 2 3 0 0 2 0 0 0 0 0 0 1
1 0 0 0 0 0 0 0 0 0 0 0 2 3 0 4 0 5 0 1
1 1 1 1 1 1 0 0 0 0 0 0 2 0 0 0 0 0 0 1
1 1 0 1 0 1 0 0 2 3 0 0 2 0 3 0 4 0 5 1
1 0 0 0 0 0 0 0 5 4 0 0 2 0 0 0 0 0 0 1
1 1 0 1 0 1 0 0 0 0 0 0 2 3 0 4 0 5 0 1
1 1 1 1 1 1 1 1 1 1 0 0 2 0 0 0 0 0 0 1
1 0 0 0 0 0 0 0 0 0 0 0 0 0 0 0 0 0 0 1
1 0 0 0 0 0 0 0 0 0 0 0 0 0 0 0 0 0 0 1
1 0 0 0 0 0 0 0 0 0 0 0 0 0 0 0 0 0 0 1
1 1 1 1 1 1 1 1 1 1 1 1 1 1 1 1 1 1 1 1
